dictionary|noun|словарь,словари|: a reference source in print or electronic form containing words usually alphabetically arranged along with information about their forms, pronunciations, functions, etymologies, meanings, and syntactic and idiomatic uses
through|preposition|через,посредством,сквозь,благодаря|used as a function word to indicate movement into at one side or point and out at another and especially the opposite side of
persist|verb|сохраняться,остаются,продолжатся,сохранять|: to continue to exist especially past a usual, expected, or normal time
overture|noun|инициатива,попытка,аванс,увертюра,увертюр|: an initiative toward agreement or action
handful|noun|горсть,горстка,небольшое количество|:as much or as many as the hand will grasp
wisdom|noun|мудрость,знания,ученость|:ability to discern inner qualities and relationships
origin|noun|происхождение,начало,корни,истоки|:rise, beginning, or derivation from a source
humble|adjective|скромный,простой,смирение|:not proud
perception|noun|восприятие,понимание,впечатление,осознание|:a mental image :obsolete
recently|adverb|недавно,давеча|:during a recent period of time
however|noun|однако,хотя,впрочем|in whatever manner or way that
brew|verb|варить,пиво|to prepare (beer, ale, etc.) by steeping, boiling, and etc. :
witness|noun|свидетель,очевидец,показания|attestation of a fact or event
vastly|adverb|значительно,гораздо,намного|to a very greate or vast degree or extent
rapidly|adjective|быстро,стремительно,оперативно,резко|marked by a fast rate of motion, activity, succession, or occurrence
fate|noun|судьба,участь,рок|destine
is at hand|verb|начинается|
seminal|adjective|основополагающий,оригинальный,эпохальный|of, relating to, or consisting of seed or semen
approach|verb|подход,метод,позиция|to make advances to especially in order to create a desired result
invariably|adverb|неизбежно,всегда,неизменно|on every occasion :always
among|preposition|среди|in or through the midst of : surrounded by
particularly|adverb|особбено,особо,наиболее|to an unusual degree
sophisticated|adjective|сложный,современный,утонченный|:highly complicated or developed
extraordinary|adjective|чрезвычайный,необычный,исключительный|going beyond what is usual, regular or customary
standout|noun|выдающийся,безусловный победитель|one that is prominent or conspicuous especially because of excellence
despite|preposition|вопреки,несмотря на,хотя|
competent|adjective|компетентный,грамотный,квалифицированный,комплексный|proper or rightly pertinent
particularly|adverb|особенно,особо,наиболее,весьма|being a single person or thing
scalable|adjective|масштабируемый,расширяемый|capable of being scaled
excellence|noun|совершенство,превосходство,мастерство|the quality of veing excellent
constrain|verb|ограничивать,сдерживать,затруднить|: to force by imposed stricture, restriction, or limitation
broader|adjective|более широкий|: having ample extent from side to side or between limits
apprehend|verb|схватить,понять,понимать,задержать,постичь|:arrest :to grasp woth the understanding: recognize the meaning of
